24 12 37 35 35 35 35 35 35 35 12 12 35 35 35 35 35 35 35 35
13 14 36 36 36 36 36 36 36 36 36 36 36 36 36 36 36 36 36 36
8 8 6 6 7 7 6 6 7 7 6 6 7 7 6 6 7 7 11 9
8 8 4 4 5 5 4 4 5 5 4 4 5 5 4 4 5 5 11 9
8 8 4 4 5 5 4 4 5 5 4 4 5 5 4 4 5 5 11 9
8 8 5 5 4 4 5 5 4 4 5 5 4 4 5 5 4 4 10 9
8 8 5 5 4 4 5 5 4 4 5 5 4 4 5 5 4 4 10 9
8 8 4 4 5 5 4 4 5 5 4 4 5 5 4 4 5 5 11 9
8 8 4 4 5 5 4 4 5 5 4 4 5 5 4 4 5 5 11 9
8 8 5 5 4 4 5 5 4 4 5 5 4 4 5 5 4 4 10 9
8 8 5 5 4 4 5 5 4 4 5 5 4 4 5 5 4 4 10 9
8 8 4 4 5 5 4 4 5 5 4 4 5 5 4 4 5 5 11 9
8 8 4 4 5 5 4 4 5 5 4 4 5 5 4 4 5 5 11 9
8 8 6 6 7 7 6 6 7 7 6 6 7 7 6 6 7 7 11 9