24 12 33 30 32 30 30 30 30 32 12 12 30 30 32 30 30 30 30 32
13 14 31 31 31 31 31 31 31 31 31 31 31 31 31 31 31 31 31 31
12 12 41 41 40 40 41 41 40 40 41 41 40 40 41 41 40 40 44 9
15 16 38 38 39 39 38 38 39 39 38 38 39 39 38 38 39 39 44 9
12 12 38 38 39 39 38 38 39 39 38 38 39 39 38 38 39 39 44 9
17 18 39 39 38 38 39 39 38 38 39 39 38 38 39 39 38 38 43 9
12 12 39 39 38 38 39 39 38 38 39 39 38 38 39 39 38 38 43 9
19 20 38 38 39 39 38 38 39 39 38 38 39 39 38 38 39 39 44 9
12 12 38 38 39 39 38 38 39 39 38 38 39 39 38 38 39 39 44 9
21 22 39 39 38 38 39 39 38 38 39 39 38 38 39 39 38 38 43 9
12 12 39 39 38 38 39 39 38 38 39 39 38 38 39 39 38 38 43 9
23 12 38 38 39 39 38 38 39 39 38 38 39 39 38 38 39 39 44 9
12 12 38 38 39 39 38 38 39 39 38 38 39 39 38 38 39 39 44 9
12 12 41 41 40 40 41 41 40 40 41 41 40 40 41 41 40 40 44 9