24 12 33 30 32 30 30 30 30 32 12 12 30 30 32 30 30 30 30 32
13 14 31 31 31 31 31 31 31 31 31 31 31 31 31 31 31 31 31 31
42 42 41 41 40 40 41 41 40 40 41 41 40 40 41 41 40 40 44 9
42 42 38 38 39 39 38 38 39 39 38 38 39 39 38 38 39 39 44 9
42 42 38 38 39 39 38 38 39 39 38 38 39 39 38 38 39 39 44 9
42 42 39 39 38 38 39 39 38 38 39 39 38 38 39 39 38 38 43 9
42 42 39 39 38 38 39 39 38 38 39 39 38 38 39 39 38 38 43 9
42 42 38 38 39 39 38 38 39 39 38 38 39 39 38 38 39 39 44 9
42 42 38 38 39 39 38 38 39 39 38 38 39 39 38 38 39 39 44 9
42 42 39 39 38 38 39 39 38 38 39 39 38 38 39 39 38 38 43 9
42 42 39 39 38 38 39 39 38 38 39 39 38 38 39 39 38 38 43 9
42 42 38 38 39 39 38 38 39 39 38 38 39 39 38 38 39 39 44 9
42 42 38 38 39 39 38 38 39 39 38 38 39 39 38 38 39 39 44 9
42 42 41 41 40 40 41 41 40 40 41 41 40 40 41 41 40 40 44 9