24 12 37 35 35 35 35 35 35 35 12 12 35 35 35 35 35 35 35 35
13 14 36 36 36 36 36 36 36 36 36 36 36 36 36 36 36 36 36 36
12 12 41 41 40 40 41 41 40 40 41 41 40 40 41 41 40 40 44 9
12 12 38 38 39 39 38 38 39 39 38 38 39 39 38 38 39 39 44 9
12 12 38 38 39 39 38 38 39 39 38 38 39 39 38 38 39 39 44 9
12 12 39 39 38 38 39 39 38 38 39 39 38 38 39 39 38 38 43 9
12 12 39 39 38 38 39 39 38 38 39 39 38 38 39 39 38 38 43 9
12 12 38 38 39 39 38 38 39 39 38 38 39 39 38 38 39 39 44 9
12 12 38 38 39 39 38 38 39 39 38 38 39 39 38 38 39 39 44 9
12 12 39 39 38 38 39 39 38 38 39 39 38 38 39 39 38 38 43 9
12 12 39 39 38 38 39 39 38 38 39 39 38 38 39 39 38 38 43 9
12 12 38 38 39 39 38 38 39 39 38 38 39 39 38 38 39 39 44 9
12 12 38 38 39 39 38 38 39 39 38 38 39 39 38 38 39 39 44 9
12 12 41 41 40 40 41 41 40 40 41 41 40 40 41 41 40 40 44 9