24 12 3 0 2 0 0 0 0 2 12 12 0 0 2 0 0 0 0 2
13 14 1 1 1 1 1 1 1 1 1 1 1 1 1 1 1 1 1 1
49 49 47 47 47 47 47 47 47 47 47 47 47 47 47 47 47 47 48 9
49 49 45 45 46 46 45 45 46 46 45 45 46 46 45 45 46 46 48 9
49 49 45 45 46 46 45 45 46 46 45 45 46 46 45 45 46 46 48 9
49 49 46 46 45 45 46 46 45 45 46 46 45 45 46 46 45 45 48 9
49 49 46 46 45 45 46 46 45 45 46 46 45 45 46 46 45 45 48 9
49 49 45 45 46 46 45 45 46 46 45 45 46 46 45 45 46 46 48 9
49 49 45 45 46 46 45 45 46 46 45 45 46 46 45 45 46 46 48 9
49 49 46 46 45 45 46 46 45 45 46 46 45 45 46 46 45 45 48 9
49 49 46 46 45 45 46 46 45 45 46 46 45 45 46 46 45 45 48 9
49 49 45 45 46 46 45 45 46 46 45 45 46 46 45 45 46 46 48 9
49 49 45 45 46 46 45 45 46 46 45 45 46 46 45 45 46 46 48 9
49 49 47 47 47 47 47 47 47 47 47 47 47 47 47 47 47 47 48 9