24 12 37 35 35 35 35 35 35 35 12 12 35 35 35 35 35 35 35 35
13 14 36 36 36 36 36 36 36 36 36 36 36 36 36 36 36 36 36 36
49 49 47 47 47 47 47 47 47 47 47 47 47 47 47 47 47 47 48 9
49 49 45 45 46 46 45 45 46 46 45 45 46 46 45 45 46 46 48 9
49 49 45 45 46 46 45 45 46 46 45 45 46 46 45 45 46 46 48 9
49 49 46 46 45 45 46 46 45 45 46 46 45 45 46 46 45 45 48 9
49 49 46 46 45 45 46 46 45 45 46 46 45 45 46 46 45 45 48 9
49 49 45 45 46 46 45 45 46 46 45 45 46 46 45 45 46 46 48 9
49 49 45 45 46 46 45 45 46 46 45 45 46 46 45 45 46 46 48 9
49 49 46 46 45 45 46 46 45 45 46 46 45 45 46 46 45 45 48 9
49 49 46 46 45 45 46 46 45 45 46 46 45 45 46 46 45 45 48 9
49 49 45 45 46 46 45 45 46 46 45 45 46 46 45 45 46 46 48 9
49 49 45 45 46 46 45 45 46 46 45 45 46 46 45 45 46 46 48 9
49 49 47 47 47 47 47 47 47 47 47 47 47 47 47 47 47 47 48 9