24 12 3 0 2 0 0 0 0 2 12 12 0 0 2 0 0 0 0 2
13 14 1 1 1 1 1 1 1 1 1 1 1 1 1 1 1 1 1 1
12 12 47 47 47 47 47 47 47 47 47 47 47 47 47 47 47 47 48 9
12 12 45 45 46 46 45 45 46 46 45 45 46 46 45 45 46 46 48 9
12 12 45 45 46 46 45 45 46 46 45 45 46 46 45 45 46 46 48 9
12 12 46 46 45 45 46 46 45 45 46 46 45 45 46 46 45 45 48 9
12 12 46 46 45 45 46 46 45 45 46 46 45 45 46 46 45 45 48 9
12 12 45 45 46 46 45 45 46 46 45 45 46 46 45 45 46 46 48 9
12 12 45 45 46 46 45 45 46 46 45 45 46 46 45 45 46 46 48 9
12 12 46 46 45 45 46 46 45 45 46 46 45 45 46 46 45 45 48 9
12 12 46 46 45 45 46 46 45 45 46 46 45 45 46 46 45 45 48 9
12 12 45 45 46 46 45 45 46 46 45 45 46 46 45 45 46 46 48 9
12 12 45 45 46 46 45 45 46 46 45 45 46 46 45 45 46 46 48 9
12 12 47 47 47 47 47 47 47 47 47 47 47 47 47 47 47 47 48 9